00000000000000000000000000000000
00000000000000000000000000000000
00000000000000000000000000000000
01000000110000000000000000000000
01000010001000000000000000000000
00000000000000000000000000000001
01000001101000000000000000000000
01000010010010000000000000000000
01000011011110100000000000000000
00000000000000000000000000000000
00000000000000000000000000000011
00000000000000000000000000000001
00000000000000000000000000000000
01000001101000000000000000000000
01000001101000000000000000000000
01000010000011000000000000000000
00000000000000000000000000000000
00000000000000000000000000000000
00000000000000000000000000000000
00111111100000000000000000000000
00111111100000000000000000000000
01000010111100000000000000000000
01000011010010000000000000000000
01000011010010000000000000000000
01000011010010000000000000000000
00000000000000000000000000000000
00000000000000000000000000000011
00000000000000000000000000000001
00000000000000000000000000000000
01000010110010000000000000000000
01000010000101000000000000000000
01000010010111000000000000000000
00000000000000000000000000000000
11000001001000000000000000000000
00000000000000000000000000000000
00111111100000000000000000000000
00111111100000000000000000000000
01000011011110100000000000000000
01000011011110100000000000000000
00000000000000000000000000000000
00000000000000000000000000000000
00000000000000000000000000000000
00000000000000000000000000000011
00000000000000000000000000000001
00000000000000000000000000000000
01000010110010000000000000000000
01000010000111000000000000000000
01000010011001000000000000000000
00000000000000000000000000000000
11000001100000000000000000000000
00000000000000000000000000000000
10111111100000000000000000000000
00111111100000000000000000000000
01000011011110100000000000000000
01000011011110100000000000000000
00000000000000000000000000000000
00000000000000000000000000000000
00000000000000000000000000000000
00000000000000000000000000000001
00000000000000000000000000000001
00000000000000000000000000000000
01000001111100000000000000000000
01000010101000000000000000000000
01000010101000000000000000000000
00000000000000000000000000000000
00000000000000000000000000000000
00000000000000000000000000000000
00111111100000000000000000000000
00111111100000000000000000000000
01000011011110100000000000000000
01000011011110100000000000000000
00000000000000000000000000000000
00000000000000000000000000000000
00000000000000000000000000000000
00000000000000000000000000000011
00000000000000000000000000000010
00000000000000000000000000000000
01000010011100000000000000000000
00000000000000000000000000000000
01000010011100000000000000000000
00000000000000000000000000000000
00000000000000000000000000000000
00000000000000000000000000000000
00111111100000000000000000000000
00111111100000000000000000000000
01000011011110100000000000000000
01000011000101100000000000000000
01000011000101100000000000000000
01000010011100000000000000000000
00000000000000000000000000000000
00000000000000000000000000000011
00000000000000000000000000000010
00000000000000000000000000000000
01000001111100000000000000000000
00000000000000000000000000000000
01000001111100000000000000000000
00000000000000000000000000000000
00000000000000000000000000000000
00000000000000000000000000000000
10111111100000000000000000000000
00111111100000000000000000000000
01000011011110100000000000000000
01000011000101100000000000000000
01000011000101100000000000000000
01000010011100000000000000000000
00000000000000000000000000000000
00000000000000000000000000000001
00000000000000000000000000000010
00000000000000000000000000000000
01000010100011000000000000000000
00111111100000000000000000000000
01000010100011000000000000000000
00000000000000000000000000000000
11000001011100000000000000000000
00000000000000000000000000000000
00111111100000000000000000000000
00111111100000000000000000000000
01000011011110100000000000000000
01000011000101100000000000000000
01000011000101100000000000000000
01000010011100000000000000000000
00000000000000000000000000000000
00000000000000000000000000000011
00000000000000000000000000000010
00000000000000000000000000000000
01000010001000000000000000000000
00000000000000000000000000000000
01000010001000000000000000000000
00000000000000000000000000000000
00000000000000000000000000000000
00000000000000000000000000000000
00111111100000000000000000000000
00111111100000000000000000000000
01000011011110100000000000000000
01000011000101100000000000000000
01000011000101100000000000000000
01000010011100000000000000000000
00000000000000000000000000000000
00000000000000000000000000000001
00000000000000000000000000000010
00000000000000000000000000000000
01000010100011000000000000000000
01000000101000000000000000000000
01000010100011000000000000000000
00000000000000000000000000000000
11000001101100000000000000000000
00000000000000000000000000000000
00111111100000000000000000000000
00111111100000000000000000000000
01000011011110100000000000000000
01000011000101100000000000000000
01000011000101100000000000000000
01000010011100000000000000000000
11111111111111111111111111111111
00000000000000000000000000000001
00000000000000000000000000000010
00000000000000000000000000000011
11111111111111111111111111111111
00000000000000000000000000000000
11111111111111111111111111111111
00000000000000000000000000000100
00000000000000000000000000000101
00000000000000000000000000000110
11111111111111111111111111111111
00000000000000000000000000000111
00000000000000000000000000001000
11111111111111111111111111111111
11111111111111111111111111111111
00000000000000000000000001100011
00000000000000000000000000000000
00000000000000000000000000000001
00000000000000000000000000000010
00000000000000000000000000000011
11111111111111111111111111111111
11111111111111111111111111111111
