11000010100011000000000000000000
01000010000011000000000000000000
11000001101000000000000000000000
01000001101000000000000000000000
01000001111100000000000000000000
00000000000000000000000000000001
01000010010010000000000000000000
01000010010010000000000000000000
01000011011111110000000000000000
00000000000000000000000000000000
00000000000000000000000000000001
00000000000000000000000000000001
00000000000000000000000000000000
01000001101000000000000000000000
01000001101000000000000000000000
01000010100000100000000000000000
00000000000000000000000000000000
01000001101000000000000000000000
01000010001101000000000000000000
00111111100000000000000000000000
00111111100000000000000000000000
01000011011110100000000000000000
01000011000000000000000000000000
01000011010100100000000000000000
00000000000000000000000000000000
00000000000000000000000000000000
00000000000000000000000000000011
00000000000000000000000000000001
00000000000000000000000000000000
01000001110010000000000000000000
01000010001000000000000000000000
01000010100011000000000000000000
00000000000000000000000000000000
00000000000000000000000000000000
01000010001000000000000000000000
00111111100000000000000000000000
00111111100000000000000000000000
01000011011110100000000000000000
01000011000000000000000000000000
01000011010100100000000000000000
00000000000000000000000000000000
00000000000000000000000000000000
00000000000000000000000000000011
00000000000000000000000000000001
00000000000000000000000000000000
00000000000000000000000000000000
01000001111100000000000000000000
01000001111100000000000000000000
00000000000000000000000000000000
11000000101000000000000000000000
00000000000000000000000000000000
10111111100000000000000000000000
00111111100000000000000000000000
01000011011110100000000000000000
01000011000000000000000000000000
01000011010100110000000000000000
00000000000000000000000000000000
00000000000000000000000000000000
00000000000000000000000000000001
00000000000000000000000000000001
00000000000000000000000000000000
01000001101000000000000000000000
01000001001000000000000000000000
01000001111100000000000000000000
00000000000000000000000000000000
11000001001000000000000000000000
01000010101000000000000000000000
00111111100000000000000000000000
00111111100000000000000000000000
01000011011110100000000000000000
01000011000000000000000000000000
01000011010100110000000000000000
00000000000000000000000000000000
00000000000000000000000000000000
00000000000000000000000000000010
00000000000000000000000000000001
00000000000000000000000000000000
00000000000000000000000000000000
10111111110000000000000000000000
10111111100000000000000000000000
00000000000000000000000000000000
00000000000000000000000000000000
01000010010010000000000000000000
00111111100000000000000000000000
00111111100000000000000000000000
01000011011110100000000000000000
01000011000000000000000000000000
01000011010100110000000000000000
00000000000000000000000000000000
00000000000000000000000000000000
00000000000000000000000000000001
00000000000000000000000000000001
00000000000000000000000000000000
01000001101100000000000000000000
01000001111000000000000000000000
01000001111000000000000000000000
00000000000000000000000000000000
11000000101000000000000000000000
00000000000000000000000000000000
00111111100000000000000000000000
00111111100000000000000000000000
01000011011110100000000000000000
00000000000000000000000000000000
01000011010100110000000000000000
01000011010100110000000000000000
00000000000000000000000000000000
00000000000000000000000000000011
00000000000000000000000000000001
00000000000000000000000000000000
01000010001000000000000000000000
01000001111000000000000000000000
01000001111000000000000000000000
00000000000000000000000000000000
11000000101000000000000000000000
00000000000000000000000000000000
00111111100000000000000000000000
00111111100000000000000000000000
01000011011110100000000000000000
00000000000000000000000000000000
01000011010100110000000000000000
01000011010100110000000000000000
00000000000000000000000000000000
00000000000000000000000000000011
00000000000000000000000000000001
00000000000000000000000000000000
00000000000000000000000000000000
01000001011100000000000000000000
01000001011100000000000000000000
00000000000000000000000000000000
11000000101000000000000000000000
00000000000000000000000000000000
10111111100000000000000000000000
00111111100000000000000000000000
01000011011110100000000000000000
00000000000000000000000000000000
01000011010100110000000000000000
01000011010100110000000000000000
00000000000000000000000000000000
00000000000000000000000000000011
00000000000000000000000000000001
00000000000000000000000000000000
01000001011100000000000000000000
01000001110010000000000000000000
01000001110010000000000000000000
00000000000000000000000000000000
11000000101000000000000000000000
01000010100011000000000000000000
00111111100000000000000000000000
00111111100000000000000000000000
01000011011110100000000000000000
01000011010100110000000000000000
00000000000000000000000000000000
00000000000000000000000000000000
00000000000000000000000000000000
00000000000000000000000000000001
00000000000000000000000000000001
00000000000000000000000000000000
01000000101000000000000000000000
01000001001100000000000000000000
01000010001101000000000000000000
00000000000000000000000000000000
01000010000011000000000000000000
01000010001000000000000000000000
00111111100000000000000000000000
00111111100000000000000000000000
01000011011110100000000000000000
01000011010100110000000000000000
01000011000000000000000000000000
00000000000000000000000000000000
00000000000000000000000000000000
00000000000000000000000000000011
00000000000000000000000000000001
00000000000000000000000000000000
01000001111100000000000000000000
01000010001101000000000000000000
01000010100101100000000000000000
00000000000000000000000000000000
00000000000000000000000000000000
01000010001000000000000000000000
00111111100000000000000000000000
00111111100000000000000000000000
01000011011110100000000000000000
01000011010100110000000000000000
01000011000000000000000000000000
00000000000000000000000000000000
00000000000000000000000000000000
00000000000000000000000000000001
00000000000000000000000000000001
00000000000000000000000000000000
01000001110010000000000000000000
01000010001001000000000000000000
01000010100011000000000000000000
00000000000000000000000000000000
01000000101000000000000000000000
01000010001000000000000000000000
00111111100000000000000000000000
00111111100000000000000000000000
01000011011110100000000000000000
00000000000000000000000000000000
00000000000000000000000000000000
00000000000000000000000000000000
00000000000000000000000000000001
00000000000000000000000000000001
00000000000000000000000000000001
00000000000000000000000000000000
01000010110010000000000000000000
01000000101000000000000000000000
01000011010010000000000000000000
00000000000000000000000000000000
11000010000011000000000000000000
01000011000101100000000000000000
00111111100000000000000000000000
00111111100000000000000000000000
01000011011110100000000000000000
01000011010010000000000000000000
01000011010010000000000000000000
01000011010010000000000000000000
00000000000000000000000000000000
00000000000000000000000000000011
00000000000000000000000000000001
00000000000000000000000000000000
01000001110010000000000000000000
01000001001000000000000000000000
01000001001000000000000000000000
00000000000000000000000000000000
11000000101000000000000000000000
00000000000000000000000000000000
00111111100000000000000000000000
00111111100000000000000000000000
01000011011110100000000000000000
01000011010100110000000000000000
01000011000000000000000000000000
01000011000000000000000000000000
00000000000000000000000000000000
00000000000000000000000000000011
00000000000000000000000000000010
00000000000000000000000000000000
01000001110010000000000000000000
01000001101000000000000000000000
01000001101000000000000000000000
00000000000000000000000000000000
00000000000000000000000000000000
01000010100011000000000000000000
00111111100000000000000000000000
00111110100110011001100110011010 ---------------
00000000000000000000000000000000
00000000000000000000000000000000
00000000000000000000000000000000
01000011011111110000000000000000
00000000000000000000000000000010
00000000000000000000000000000011
00000000000000000000000000000001
00000000000000000000000000000000
01000001101000000000000000000000
01000001101000000000000000000000
01000001101000000000000000000000
01000010110010000000000000000000
01000010001000000000000000000000
01000010111100000000000000000000
00111111100000000000000000000000
00111111100000000000000000000000
01000011000101100000000000000000
01000011011111110000000000000000
01000011011111110000000000000000
01000011011111110000000000000000
00000000000000000000000000000000
00000000000000000000000000000010
00000000000000000000000000000010
00000000000000000000000000000000
00000000000000000000000000000000
00000000000000000000000000000000
10111111100000000000000000000000
00000000000000000000000000000000
00000000000000000000000000000000
01000011010010000000000000000000
00111111100000000000000000000000
00111110010011001100110011001101 ----
00000000000000000000000000000000
01000011011111110000000000000000
00000000000000000000000000000000
00000000000000000000000000000000
11111111111111111111111111111111
00000000000000000000000000000000
00000000000000000000000000000001
00000000000000000000000000000010
11111111111111111111111111111111
00000000000000000000000000000011
00000000000000000000000000000001
00000000000000000000000000000100
11111111111111111111111111111111
00000000000000000000000000000101
00000000000000000000000000000110
00000000000000000000000000000111
11111111111111111111111111111111
00000000000000000000000000001000
11111111111111111111111111111111
00000000000000000000000000001001
00000000000000000000000000001010
11111111111111111111111111111111
00000000000000000000000000001100
11111111111111111111111111111111
00000000000000000000000000001101
11111111111111111111111111111111
00000000000000000000000000001110
11111111111111111111111111111111
00000000000000000000000000001111
11111111111111111111111111111111
00000000000000000000000000010000
11111111111111111111111111111111
11111111111111111111111111111111
00000000000000000000000000001011
00000000000000000000000000000000
00000000000000000000000000000001
00000000000000000000000000000010
00000000000000000000000000000011
00000000000000000000000000000100
00000000000000000000000000000110
11111111111111111111111111111111
00000000000000000000000001100011
00000000000000000000000000001001
00000000000000000000000000001000
00000000000000000000000000000111
00000000000000000000000000000101
11111111111111111111111111111111
11111111111111111111111111111111
